00000000000000000000000000000000000000000
00000000000000000000000000000000000000000
00000000000000000000000000000000000000000
00000000000000000000000000010000000000000
00000000000000100000000000110000000000000
00000000000000100000000000110000000000000
00000000000000100000000000111000000000000
00001000000001100000000000111000000000000
00001000000001100000000000111000000000000
00011000000001100000000000111100000000000
00011000000011100000000000111100000000000
00011000000011100000000001111110000000000
00011100000011100000000011111110000000000
00011100000011100000000111111111110000000
00011111000111110000000111111111110000000
00111111111111111100000111111111111000000
22222222222222222222222222222222222222222
11111111111111111111111111111111111111111
11111111111111111111111111111111111111111
11111111111111111111111111111111111111111
