00000000000000000000000000000000000000000
00000000000000000000000000000000000000000
00000000000000000000000000000000000000000
00000000000000000000000000010000000000000
00000000000000000000000000110000000000000
00000000000000000000000000110000000000000
00000000000000000000000000111000000000000
00000000000000000000000000111000000000000
00000000000000000000000000111000000000000
00010000000000000000000000111100000000000
00010000000000000000000000111100000000000
00011000000000000000000001111110000000000
00011100000000000000000011111110000000000
00011100000000000000000111111111110000000
00011111000000000000000111111111110000000
00111111110000000000000111111111111000000
22222222222222222222222222222222222222222
11111111111111111111111111111111111111111
11111111111111111111111111111111111111111
11111111111111111111111111111111111111111
